17
17
1 2 1 4 3 2 2 1 1 1 1 2 1 4 3 2 2
4 3 2 2 1 3 1 1 2 2 4 3 2 2 1 3 1
1 3 1 3 1 1 2 1 1 1 1 3 1 3 1 1 2
3 4 3 3 2 1 2 1 4 1 3 4 3 3 2 1 2
1 1 3 4 3 3 3 2 2 2 1 1 5 4 3 3 3
1 2 3 1 3 1 2 2 1 1 1 2 3 1 3 1 2
1 1 2 3 2 1 1 1 3 1 1 2 3 1 3 1 2
2 2 2 1 3 1 1 6 5 3 1 2 3 1 3 1 2
3 4 2 1 1 1 2 3 2 1 3 4 2 1 1 1 2
2 3 1 1 1 2 2 3 1 1 2 2 2 1 3 1 1
1 2 1 4 3 2 2 1 1 1 1 1 2 3 2 1 1
4 3 2 2 1 3 1 1 2 2 2 3 1 1 1 5 2
1 3 1 3 1 1 2 1 1 1 2 3 1 1 6 0 7
3 4 3 3 2 1 2 1 4 7 8 3 2 2 1 8 1
1 1 3 4 3 3 3 2 2 2 4 3 2 2 1 3 8
1 2 3 1 3 1 2 2 1 1 3 4 3 3 2 1 2
1 1 2 3 2 1 1 1 3 1 1 3 1 3 1 1 2