11
11
1 1 1 1 1 1 1 1 1 1 1
1 7 7 7 7 7 7 7 7 7 1
1 7 7 7 7 7 7 7 7 7 1
1 7 7 7 7 7 7 7 7 7 1
1 7 7 7 7 7 7 7 7 7 1
1 7 7 7 7 0 7 7 7 7 1
1 7 7 7 7 7 7 7 7 7 1
1 7 7 7 7 7 7 7 7 7 1
1 7 7 7 7 7 7 7 7 7 1
1 7 7 7 7 7 7 7 7 7 1
1 1 1 1 1 1 1 1 1 1 1
